一、Win键相关的快捷键
键位	操作
Win + Home	将所有使用中窗口以外的窗口最小化（和摇动使用中窗口一样意思）
Win + Space空格键	将所有桌面上的窗口透明化（和鼠标移到工作列的最右下角一样意思）
Win +上方向键	最大化使用中窗口（和将窗口用鼠标拖到屏幕上缘一样意思）
Shift + Win +上方向键	垂直最大化使用中窗口（但水平宽度不变）
Win +下方向键	最小化窗口／还原先前最大化的使用中窗口
Win +左／右方向键	将窗口靠到屏幕的左右两侧（和将窗口用鼠标拖到左右边缘一样意思）
Shift + Win + 左／右方向键	将窗口移到左、右屏幕（如果你有接双屏幕的话）工作列快速列
Win + 1~9	开启工作列上相对应的软件，从左到右依顺序为Win+1到Win+9
Shift + Win + 1~9	开启对应位置软件的一个新「分身」，例如firefox的话会是开新窗口（鼠标是Shift+点软件）
Ctrl + Win + 1~9	在对应位置软件已开的分身中切换
Alt + Win + 1~9	开启对应位置软件的右键选单
Ctrl + Shift
+ 鼠标单击软件	以管理员权限开启该软件
WIN + 点击任务栏快捷方式	在此程序中新建一个实例
Win + (+/-)：　　　　　　	打开Windows放大、缩小功能
Win + G	在屏幕上的Gadget 间切换
Win + X	打开移动中心
Win + D	显示桌面，最小化所有窗口
Win + E	打开资源管理器
Win + F	打开资源管理器搜索结果
Win + L	锁定计算机，回到登陆窗口
Win + M	最小化当前窗口
Win + P	投影机输出设定（仅屏幕、同步显示、延伸、仅投影机）
Win + R	打开运行窗口
Win + T	工作列的Alt + Tab
Win + U	打开控制面板轻松访问中心
Win + Break	打开控制面板系统属性
Win + Tab	打开Flip3D任务切换功能

二、Windows基础快捷键
键位	操作
F1	帮助
Ctrl + C ( Ctrl + Insert)	复制选中项目
Ctrl + X	剪切选中项目
Ctrl + V ( Shift + Insert)	粘贴选中项目
Ctrl + Z	撤销
Ctrl + Y	重做
Delete ( Ctrl + D)	删除选中项目至回收站
Shift + Delete	直接删除选中项目
F2	重命名选中项目
Ctrl + A	全选
F3	搜索
Alt + Enter	显示选中项目属性
Alt+F4	关闭当前项目或退出当前程序
Alt+空格	打开当前窗口的快捷方式菜单
Alt + Tab	在当前运行的窗口中切换
Ctrl + Alt + Tab	使用方向键在当前运行的窗口中切换
Ctrl + 滚轮	改变桌面图标大小
Windows徽标+Tab	开启Aero Flip 3-D
Ctrl+ Windows徽标+Tab	使用方向键在 Aero Flip 3D程序中切换
Alt + Esc	在当前打开的程序间切换
F4	显示资源管理器的地址栏列表
Shift+F10	显示选中项目的快捷方式菜单
Ctrl + Esc	打开开始菜单
F10	激活当前窗口的菜单栏
F5 ( Ctrl + R)	刷新
Alt+ ↑	资源管理区中返回文件夹的上一级菜单
Esc	取消当前操作
Ctrl + Shift + Esc	打开任务栏管理器
插入碟片时按住Shift	禁止CD/DVD的自动运行
右边或左边的 Ctrl+ Shift	改变阅读顺序
三、资源管理器相关快捷键
键位	操作
Ctrl + N	打开新窗口
Ctrl + W	关闭当前窗口
Ctrl + Shift + N	新建文件夹
End	显示文件夹底部
Home	显示文件夹顶部
F11	最大/最小化当前文件夹
Ctrl + 句号 (.)	顺时针方向旋转图片
Ctrl + 逗号 (,)	逆时针方向旋转图片
Num Lock + 小键盘星号 (*)	显示选中文件夹下的所有子文件夹
Num Lock + 小键盘加号( + )	显示选中文件夹的内容
Num Lock + 小键盘减号 (-)	折叠选中文件夹
←	折叠选中文件夹或返回父文件夹
Alt + Enter	打开选中项目的属性对话框
Alt + P	预览面板开关
Alt + ←	打开上一个文件夹
Backspace	打开上一个文件夹
→	选中第一个子文件夹
Alt + →	打开下一个文件夹
Alt + ↑	返回上一层文件夹
Ctrl + 滚轮	改变图标大小
Alt + D	选中地址栏
Ctrl + E	选中搜索框
Ctrl + F	选中搜索框
Shift+右键点选文件	出现「附到开始菜单」和「复制为路径」两个额外的右键选项
Shift+右键点选文件夹	出现「在新处理程序开启（另开新窗口）」、
「在此处开启命令窗口（DOS!）」和
「复制为路径」三个额外的右键选项
四、任务栏快捷键
键位	操作
Shift + 点击任务栏程序按钮	在新窗口中打开此程序
Ctrl + Shift + 点击任务栏程序按钮	以管理员身份运行此程序
Shift + 右键点击任务栏程序按钮	打开此程序的窗口菜单
Shift + 右键点击任务栏分组按钮	打开本组的窗口菜单
Ctrl + 点击任务栏分组按钮	在本组窗口中循环